_____T_____
__T________
_____X_____
__T________
______T____
